00000000000000000
00000000000000000
00222222222222200
00200000000000200
00203030303030200
00203030303030200
00203030303030200
00000000000000000
00203030303030200
00203030303030200
00203030303030200
00200000000000200
00222222222222200

00000000000000000
00000000000000000
00444444444444400
00400000000000400
00403333333330400
00403000000030400
00403022222030400
00403020002030400
00403022222030400
00403000000030400
00403333333330400
00400000000000400
00444444444444400

00000000000000000
00000000000000000
00066066066066000
00066066066066000
00066066066066000
00066066066066000
00066066066066000
00066066066066000
00000000000000000
00000000000000000
00066066066066000
00066066066066000
00066066066066000
00066066066066000
00066066066066000
00066066066066000

00000000000000000
00000000000000000
00000008980000000
00000087478000000
00000870407800000
00008705450780000
00086053435068000
00870630403607800
08705350405350780
09053005450035090
09444444844444490
09053005450035090
08705350405350780
00870630403607800
00086053435068000
00008705450780000
00000870407800000
00000087478000000
00000008980000000
