00000000000000000
00000000000000000
00111111111111100
00100000000000100
00101010101010100
00101010101010100
00101010101010100
00000000000000000
00101010101010100
00101010101010100
00101010101010100
00100000000000100
00111111111111100

00000000000000000
00000000000000000
00111111111111100
00100000000000100
00101111111110100
00101000000010100
00101011111010100
00101010001010100
00101011111010100
00101000000010100
00101111111110100
00100000000000100
00111111111111100

00000000000000000
00000000000000000
00011011011011000
00011011011011000
00011011011011000
00011011011011000
00011011011011000
00011011011011000
00000000000000000
00000000000000000
00011011011011000
00011011011011000
00011011011011000
00011011011011000
00011011011011000
00011011011011000

00000000000000000
00000000000000000
00000001110000000
00000011111000000
00000110101100000
00001101110110000
00011011111011000
00110110101101100
01101110101110110
01111001110011110
01111111111111110
01111001110011110
01101110101110110
00110110101101100
00011011111011000
00001101110110000
00000110101100000
00000011111000000
00000001110000000
